.P.M.#MT#M..
####.M.T.#.E
P#TP.P#....P
..#...#..M..
.P..T..#P..T
.....#.TM.T.
.PP##P..M..#
#...M...T.TM
.P....#.P..P
##.#......##
.#.T...P##P.
#..#S#P....M