####.#..#.#MP
.M.T.#.M.M..M
...#...#M..M.
..P#P.P.#PP#T
T#M..#.#TT...
..P#PMM...T..
#..PP##...T.M
..#.##TTT###T
##EMP##MP.#..
##P...#...TM#
.#M..P..P....
..#M...T#S.#.
#..#P#.#..TMP