#PM#.......#.P
.T#TM.P.#.##.#
...##MM###.T#.
#PPP#..S##..TM
TT#T.#MMP##.#P
#PT...P.T...#T
.PMM.##...TT.T
.#...#..#..##P
.P..##.T.#....
#..#PTPPP#..T#
...M.P#......#
..#P###T.PT#PM
..#P........#.
#..P..#.E...#.