P#T#.P.##...
.#.#...##..T
.M.###.M....
#.###T#.####
#.##....M.T#
#.S#.##T#M##
#.....##...E
#..T#..#..##
#####.#...M.
#..M.....#..
#T.#.###M#.P
#..M.#P..###