.P##..##....
#MT.E.PPP.##
##.P##TT.M..
.T#..MP#T##.
P.#..#.#...#
T.#.###T#.#.
##T..M.#TT##
...M#T.M#.P#
#.M..M.##...
MP.#..##.P.#
S..#.T......
..M....T#.T.