T######.T#.E
P#.P.....#..
.#....#M##..
M#M####PP#..
....P.##M#..
T#.....P..M.
.########M##
.#T.T.P.#..#
.#...#..#T.#
T##M###M##.#
....#S#....#
###...M.####