####.#T.#.P#
T###..#.#..#
.#..#.....##
..#...##..##
#.#...####T#
..#.#.M.T.M.
M...#.##..#.
.##.MP#PM.S.
T#T#####.##T
.M..##...###
M#M#.##.####
P#E..#######