P#T...###T.#
.##...P#...#
.....M#....T
#..##...#..#
T###...##M.#
M.M..#....##
#.#.#PM##.##
#T#.##....##
.M..M.T#...T
...######S..
.#.#########
E.P#########