T######.T#.E
.#.......#..
.#....#M##..
M#M####PP#..
......##M#..
T#..........
.########M##
.#T.T#P.#.P#
.#...#..#T.#
T##M###M##.#
....#S#....#
###...M.####