##T..#####.P
####.#T###..
#.T#.#...#..
#M#.M..#...#
P...#..##.##
#M##..#P#.M.
.....##M#.#T
T.##.##...##
..##T#S#.T##
#MP##..#M###
#...M..#.###
######.#.E##