P..M##.....#
###....###.T
.T..####P.M#
E.##T#T###..
.##..#.#.##.
M.##...#....
.#T##..M.#M#
.M..#.###..#
#.#M..#..T.#
.M...##...##
P.##.###.#S.
##P..#T....#