###P#.......
T.#T..#.###S
..M.##..TT##
##....M###.P
P#...#......
M###.P#.##M#
...M..#.#..#
M###.......#
T#.M....##.#
##.####.##..
#E.#..M.##.T
####T.######