#####T.#####
####.#M####T
##E#....MP#T
##.#M#..#...
##...#......
##P.#.......
T###M.#T###P
..##.###MS##
..T#.....###
##..M###M###
#PM.####T###
##....######