P..M##.....#
###....###.T
.T..####P.M#
S.##T#T###..
.##..#.#.##.
M.##...#....
.#T##..M.#M#
.M..#.###..#
#.#M..#..T.#
.M...##...##
P.##.###.#E.
##P..#T....#