.P#.#.S##.##
..#T.M....##
.##..##...##
....#T.M..##
M#.###.##M.#
.T###P.P#..#
.T#..#.##..#
#.#..##T..##
#..M.....M.T
..M#....#..#
.#...#####.#
M..T...E##.P