P#T#.P.##...
.#.#...##..T
.M.###.M....
#.###T#.####
#.##....M.T#
#.E#.##T#M##
#.....##...S
#..T#..#..##
#####.#...M.
#..M.....#..
#T.#.###M#.P
#..M.#P..###