..E#T##M...#
#.##.#..#PP#
#........###
....##..####
....##.##T##
T##.##..#...
#M###TM..#M.
...###PM...#
##T...M##..T
###.#####...
##.M..P#S#M#
T..#..##...#