T.E.#T..
M.....M.
#.###..P
T..M.##.
M.P#..M.
...#M.#M
.S....#T
.TT..P#P