..MT.M...P
P#M##.##.E
.T..PP.#T#
.#.....#.P
...#.#.#..
M..#S#.#..
M..#.#.M.T
.P#M...#.#
.T#..#.#.T
M....P.#MM