T#.#.M...P#P
#.#####.M#.#
.#M......#..
P##S.#..#P#T
..##.##.P#.#
#.#.T..#P.P.
E###P##TT#..
.#M..#.#TM#P
.M.P.##TMP#P
..P.P..##.T.
MP...#.M#.T.
.#####..P.##