.#.#.PT.#.##P#
##M.#T#....P..
.M##M#T.###..#
#T.##.....T##P
#.#.T.#####.P.
##.#TP..T##E#.
..M.T.##.P.P#T
#..#.....PPT##
...#####.##M.#
.P.#TM....#.M.
P.T.M###.T#...
#..SM##.P#..MP
.....#..TM.##.
.#T#...T..M#P.