###P...#..E.#
P##P..##..T#T
...P..TTT###T
...#.##..##..
#.##..#..##..
##...PT.M#..M
#TT.P......#.
.#.MP#T......
.#.#.###.#TPT
.M..#T.TP...M
#..T#M...#..#
MT##P.###MT.M
..MMSM.T#T#..