.M.#M...#..#..
.P.P..P.....#.
##T#.###..####
TM.MP.TE.T.###
P...#...PM..#T
..M.#.##...#.#
.....#....MTTM
.T.#.#....#.TP
M..P##P.##M.##
.MP.##P....##.
P#.PP##.T.T.PP
.TMP#P...T#S#.
P.MM#PP.P#M..#
...#..M.......