##...P.###T..P
.#T.P...MT..T.
##T..#.P....P.
.....##..P.#..
#..P..#.TEP###
P.#MTPT#..#..#
.#...M.##MP...
P#.#.T###...P.
MM.PP#..#...#.
.##..M..M.##..
#.#....#.#.M#.
.T....##.#...#
P.....#...M.T#
#P.ST...##.##M